{
  "levelId": 12,
  "levelMap": [
    [0,0,0,7,0,0,0,0,0,0,0,0,7,0,0,0,0,0,7,0],
    [0,0,0,7,0,0,0,0,0,0,0,0,0,7,0,0,0,0,0,0],
    [0,7,0,0,0,0,0,0,0,7,0,0,7,0,0,0,0,7,0,0],
    [7,0,0,7,0,7,0,0,0,0,0,0,0,0,0,7,0,0,0,0],
    [0,9,0,0,0,0,7,0,0,0,1,0,0,0,0,0,7,0,0,0],
    [0,0,0,7,0,0,0,0,0,0,0,0,0,0,0,7,0,0,0,0],
    [0,7,0,0,0,7,0,0,0,7,0,0,7,0,0,0,0,0,0,0],
    [7,0,0,7,0,7,0,0,0,0,0,0,0,7,0,0,0,0,7,0],
    [0,0,7,0,0,0,0,0,0,0,0,0,7,0,0,0,0,7,0,0],
    [0,0,0,0,0,7,0,0,0,0,0,7,0,0,0,0,0,0,0,0]
  ],
  "blackoutIntervalTime": 4.3,
  "blackoutPeriod": 5.5,
  "texts": [
    "Wake up sir",
    "He is completely mad"
  ],
  "listOfPowerUps": [0,1,2]
}