{
  "levelId": 4,
  "levelMap": [
    [0,0,0,0,0,0,0,0,0,0,0,0,0,0,0,0,0,0,0,0],
    [0,1,0,0,0,0,0,0,0,0,0,7,0,0,0,0,0,7,0,0],
    [0,0,0,0,0,0,0,0,0,0,0,0,0,0,0,0,0,0,0,0],
    [0,7,7,7,7,7,7,0,0,0,0,0,0,0,0,0,0,0,0,0],
    [0,0,0,7,0,0,0,0,7,0,0,0,0,0,0,0,7,0,0,0],
    [0,0,0,0,0,0,0,0,7,0,0,0,0,0,0,0,0,7,0,0],
    [0,7,0,9,0,7,0,0,7,0,0,0,0,0,0,0,0,0,0,0],
    [0,0,0,0,0,0,0,0,0,0,0,0,0,0,0,0,0,0,0,0],
    [0,0,0,7,0,0,0,0,0,0,0,0,0,0,0,7,0,0,0,0],
    [0,0,0,0,0,0,0,0,0,0,0,0,0,0,0,0,0,0,0,0]
  ],
  "blackoutIntervalTime": 10,
  "blackoutPeriod": 2.0,
  "texts": [
    "Wake up sir",
    "He is completely mad"
  ],
  "listOfPowerUps": [0,1,2]
}