{
  "levelId": 6,
  "levelMap": [
    [7,7,0,0,0,0,0,0,0,0,0,0,0,0,0,0,0,0,0,0],
    [7,7,0,0,0,0,0,0,0,0,0,0,0,0,0,0,0,0,0,7],
    [7,0,0,0,0,0,0,0,0,0,0,0,7,9,7,0,0,0,0,0],
    [0,0,0,0,0,0,0,0,0,0,0,0,7,0,7,0,0,0,0,0],
    [0,0,0,0,0,0,0,0,0,0,0,7,7,7,7,7,0,0,0,0],
    [0,0,0,0,7,0,0,0,0,0,0,0,0,0,0,0,0,0,0,0],
    [0,0,0,0,7,0,0,0,0,0,0,0,0,0,0,0,0,0,0,0],
    [0,1,0,0,0,0,0,0,0,0,0,0,0,0,0,0,0,0,0,0],
    [0,0,0,0,0,0,0,0,0,0,0,0,0,0,0,7,0,0,0,0],
    [0,0,0,0,0,0,0,0,0,0,0,0,0,0,0,7,0,0,0,0]
  ],
  "blackoutIntervalTime": 8,
  "blackoutPeriod": 2.4,
  "texts": [
    "Wake up sir",
    "He is completely mad"
  ],
  "listOfPowerUps": [0,1,2]
}