{
  "levelId": 15,
  "levelMap": [
    [7,0,0,0,0,0,7,7,7,7,7,0,7,7,7,7,7,0,0,0],
    [7,0,0,0,0,0,0,0,7,0,0,0,7,0,0,0,7,0,0,0],
    [7,0,0,0,0,0,0,0,7,0,0,0,7,7,7,7,0,0,0,0],
    [7,0,0,0,0,0,0,0,7,0,0,0,7,0,0,0,7,0,0,0],
    [7,7,7,7,7,0,7,7,7,7,7,0,7,7,7,7,7,0,0,0],
    [7,7,7,7,7,0,7,7,7,0,0,0,7,0,0,0,7,0,0,0],
    [7,0,0,0,0,0,7,0,0,7,0,0,0,7,0,7,0,0,0,0],
    [7,0,7,0,7,0,7,0,0,7,7,0,0,0,9,1,0,0,0,0],
    [7,0,0,0,7,0,7,0,0,7,0,0,0,7,0,7,0,0,0,0],
    [7,7,7,7,7,0,7,7,7,0,0,0,7,0,0,0,7,0,0,0]
  ],
  "blackoutIntervalTime": 3.4,
  "blackoutPeriod": 6.5,
  "texts": [
    "Wake up sir",
    "He is completely mad"
  ],
  "listOfPowerUps": [0,1,2]
}