{
  "levelId": 14,
  "levelMap": [
    [0,0,0,0,0,0,0,0,0,0,0,0,0,7,0,0,0,0,0,0],
    [0,0,7,0,0,0,0,7,0,0,0,7,0,0,0,7,0,0,0,7],
    [7,0,0,0,7,0,0,0,0,0,7,0,0,0,0,0,0,7,0,0],
    [0,0,7,0,0,0,0,0,0,0,0,0,0,0,0,0,0,0,0,0],
    [0,7,0,7,0,0,0,7,0,0,0,0,0,1,0,0,0,0,0,0],
    [0,0,0,0,0,7,0,0,0,7,0,0,0,0,0,0,0,0,0,7],
    [0,0,0,0,0,0,0,0,0,0,0,0,0,7,0,0,0,0,0,0],
    [7,7,0,0,0,7,9,0,0,0,0,7,0,0,0,0,0,0,0,0],
    [0,0,0,0,0,0,0,7,0,0,0,0,0,0,0,0,0,0,0,7],
    [0,0,0,7,0,0,0,0,0,0,0,0,7,7,0,0,0,0,0,0]
  ],
  "blackoutIntervalTime": 3.7,
  "blackoutPeriod": 6.2,
  "texts": [
    "Wake up sir",
    "He is completely mad"
  ],
  "listOfPowerUps": [0,1,2]
}