{
  "levelId": 11,
  "levelMap": [
    [0,0,0,0,0,0,0,0,0,7,0,0,0,0,0,0,0,0,0,0],
    [0,0,1,0,0,0,0,0,0,0,0,0,0,0,0,0,0,7,0,0],
    [7,0,0,0,0,0,0,7,0,7,0,0,7,0,0,0,0,0,0,0],
    [0,7,0,0,7,0,0,7,0,0,0,0,0,0,0,7,0,0,0,0],
    [9,0,0,0,0,0,0,0,0,0,0,0,7,0,0,0,0,0,7,0],
    [0,0,7,0,0,0,0,0,0,0,0,0,0,7,0,0,0,0,0,0],
    [0,0,0,0,0,0,0,0,0,0,0,0,0,0,0,7,0,0,0,0],
    [0,7,0,0,0,0,0,0,0,0,0,0,0,0,0,0,7,0,0,0],
    [7,0,0,0,0,0,0,0,0,0,0,0,0,0,7,0,0,0,0,0],
    [0,0,0,0,0,0,0,0,0,0,0,0,0,7,0,0,0,0,0,0]
  ],
  "blackoutIntervalTime": 4.8,
  "blackoutPeriod": 5.2,
  "texts": [
    "Wake up sir",
    "He is completely mad"
  ],
  "listOfPowerUps": [0,1,2]
}